111111111111111111111111111111111
100000000000000000000000000001111
100000000000000000011111100001111
100000P00000000000010000100001111
100000000000000000011111100001111
100000000000000000000000000001111
10000000C0000C0000000000000001111
1000000000000000000E0000000001111
111111111111111111111111111111111