11111111111111111111111111111111
10000000000000000000000000000001
10000000000000000000011111100001
100000000000000P0000010000100001
10000000000000000000011111100001
10000000000000000000000000000001
1000000000C0000C0000000000000001
100000000000000000000E0000000001
11111111111111111111111111111111