11111111111111111111111111111111
10000000000000000000000000000001
10000000000000000000011111100001
10000000000000000000010000100001
10000000000000000000011111100001
10000000000000000000000000000001
10000000000000P00000000000000001
100000000000000C00000E0000000001
11111111111111111111111111111111