1111111111111111111111111111111
1000000000000000000000000000011
1000000000000000000111111000011
100000P00000000000000C001000011
1000000000000000000111111000011
1000000000000000000000000000011
10000000C0000C00000000000000011
1000000000000000000E00000000011
1111111111111111111111111111111